0000000000
1000000000
2200000000
0220000000
0022200000
0000200000
0000222200
0000000200
0000000220
0000000023