0000000000
2000000000
1100000000
0110000000
0011100000
0000100000
0000111100
0000000100
0000000110
0000000012